07070707070707070707070707070707070707070707070707070707070707070707070707070707070707070707070707070707
07070707070707070707070707070707070707070707070707070707070707070707070707070707070707070707070707070707
07070707070707070707070707070707070707070707070707070707070707070707070707070707070707070707070707070707
07070707070707070707070707070707070707070707070707070707070707070707070707070707070707070707070707070707
07070707070707070707070707070707070707070707070707070707070707070707070707070707070707070707070707070707
07070707070707070707070707070707070707212733070707070707070707070707070707070707070707070707070707070707
07070707070707070707072127330707070707222834070707070707070707070707070707070707070707070707070707070707
07070707070707070707072228342127330707232935070707070707070707070707070707070707070707070707070707070707
07070707070707070707072329352228340707051117070707070707070707070707070707070707070707070707070707070707
07070707070721273321270511172329350718242424242430070707070707070707070707070707070707070707070707070707
07070707070722283422283407070511170713252525252531070707070707070707070707070707070707070707070707070707
07070707070723293523293507030707070713252525252531070707070707070707070707070707070707070707070707070707
07070707070705111705111718242424242414252525252531070707070707070707070707070707070707070707070707070707
07070707070721273307070719252525252525252525252502242424242424242424242430070707070707070707070707070707
07070707070722283407070719252525252525252525252525252525252525252525252531070707070707070707070707070707
07070707070723293507070720262626262626262626261225252525252525252525252531090707070707070707070707070707
07070707070705111707070707070707070707070707071325252525252525252525252531070707070707070707070707070707
07070707070707070707070707070707070707070707071325252525252500262626262632070707070707070707070707070707
07070707070707070707070707070707070707070707072026262626262632070707070707070707070707070707070707070707
07070707070707070707070707070707070707070707070707070707070707070707070707070707070707070707070707070707
07070707070707070707212733070707070707070707070707070707070707070707070707070707070707070707070707070707
07070707070707070707222834070707070707070707070707070707070707070707070707070707070707070707070707070707
07070707070707070707232935070707070707070707070707070707070707070707070707070707070707070707070707070707
21273321273321273307051117070707070707070721273307070707070707070707070707070707070707070707070707070707
22283422283422283407070707070707070707070722283407070707070707070707070707070707070707070707070707070707
23293523293523293507070707070707070707070723293507070707070707070707070707070707070707070707070707070707
05111705111705111707070707070707070707070705111707070707070707070707070707070707070707070707070707070707
----
-67
-453
0
10